
C 226,30,0
F 2,1,100



NO ./texturs/w1.xpm
SO ./texturs/w2.xpm
WE ./texturs/w3.xpm
EA ./texturs/w4.xpm



        1111111111111111111111111
        1000N00000110000000000001
        1011000001110000000000001
        100100000000000000000001
111111111011000001110000000000001
100000000011000001110111111111111
11110111111111011100000010001
11110111111111011101010000001
11000000110101011100000000001
10000000000000001100000000001
10000000000000000010100100011
1100000111010101111101111000111
11110111 1110101 101111010001
11111111 1111111 111111111111