
F 2,1,100
C 225,30,0





NO ./path_to_the_north_texture
SO ./path_to_the_south_texture
WE ./path_to_the_west_texture
EA ./path_to_the_east_texture



111111 111111
01111111  00 1